#Ireland
OSR = "countries/Ossory.txt"
AGH = "countries/Armagh.txt"
CRC = "countries/Carrick.txt"
DUB = "countries/Dublin.txt"
ELI = "countries/Ely.txt"
FIR = "countries/Fermanagh.txt"
MYO = "countries/Mayo.txt"
#Scotland
CBH = "countries/Cataibh.txt"
GBH = "countries/Gallaibh.txt"
RHE = "countries/Rheged.txt"
GLW = "countries/Galloway.txt"
AGU = "countries/Angus.txt"
#Wales
GWY = "countries/Gwynedd.txt"
PWS = "countries/Powys.txt"
DEH = "countries/Deheubarth.txt"
MRG = "countries/Morgannwg.txt"
#England
MRC = "countries/Mercia.txt"
ANG = "countries/Anglia.txt"
YRK = "countries/York.txt"
DRH = "countries/Durham.txt"
ESX = "countries/Essex.txt"
KNT = "countries/Kent.txt"
SSX = "countries/Sussex.txt"
WSX = "countries/Wessex.txt"
LNC = "countries/Lancaster.txt"
#Spain
SLM = "countries/Salamanca.txt"
BGC = "countries/Braganca.txt"
PLN = "countries/Palencia.txt"
RIO = "countries/Rioja.txt"
BET = "countries/Betica.txt"
CAC = "countries/Caceres.txt"
BJA = "countries/BejaSp.txt"
CTA = "countries/Carthagena.txt"
ABC = "countries/Bacete.txt"
LCA = "countries/Lucento.txt"
XAT = "countries/Xativa.txt"
TRC = "countries/Taraco.txt"
BCA = "countries/Barcelona.txt"
ADR = "countries/Andorra.txt"
URG = "countries/Urgell.txt"
ELB = "countries/Elbora.txt"
BGO = "countries/Burgos.txt"
#France
POI = "countries/Poitiers.txt"
ANJ = "countries/Anjou.txt"
WLN = "countries/Wallonia.txt"
MNC = "countries/Monaco.txt"
NAR = "countries/Narbonne.txt"
LAV = "countries/Laval.txt"
VED = "countries/Vendome.txt"
TOS = "countries/Tours.txt"
PRI = "countries/Perigord.txt"
#Italy
RAV = "countries/Ravenna.txt"
ANC = "countries/Ancona.txt"
IST = "countries/Istria.txt"
TRN = "countries/Torino.txt"
NIC = "countries/Nice.txt"
BRC = "countries/Brescia.txt"
BNV = "countries/Benevento.txt"
CNO = "countries/Cuneo.txt"
NVA = "countries/Novara.txt"
AVL = "countries/Avellino.txt"
FOG = "countries/Foggia.txt"
PAV = "countries/Pavia.txt"
CRM = "countries/Cremona.txt"
SMR = "countries/SanMarino.txt"
CSP = "countries/Cospaia.txt"
CDA = "countries/Albe.txt"
BOJ = "countries/Boiano.txt"
TNI = "countries/Trani.txt"
ABO = "countries/Arborea.txt"
PLM = "countries/Palermo.txt"
SEB = "countries/Seborga.txt"
MSS = "countries/Massa.txt"
#Germany
BRN = "countries/Bern.txt"
LOM = "countries/Longobardi.txt"
WIE = "countries/Wien.txt"
OST = "countries/Ostphalia.txt"
AGR = "countries/Angria.txt"
AUT = "countries/Austrasia.txt"
SCH = "countries/Schwyz.txt"
ILA = "countries/Illanz.txt"
HEL = "countries/Helgoland.txt"
DAV = "countries/Davos.txt"
#Poland
VEL = "countries/Veleti.txt"
SPR = "countries/Sprevia.txt"
WRO = "countries/Wroclaw.txt"
ZAT = "countries/Zator.txt"
BDO = "countries/Bardo.txt"
GDA = "countries/Gdansk.txt"
PYR = "countries/Pyrzyce.txt"
SLU = "countries/Slupsk.txt"
#Balkans
BES = "countries/Besarabia.txt"
OLT = "countries/Oltenia.txt"
RSK = "countries/Raska.txt"
BCV = "countries/Branicevo.txt"
BEL = "countries/Belgrade.txt"
SLJ = "countries/Solj.txt"
SZL = "countries/Slavonia.txt"
DKR = "countries/DonjiKraji.txt"
#Middle East
SYP = "countries/SyriaPalestine.txt"
#Finland
TAV = "countries/Tavastania.txt"
SVO = "countries/Savo.txt"
#Africa
CTE = "countries/Carthage.txt"
LAG = "countries/Laghouat.txt"
KDI = "countries/Kasdir.txt"
FIG = "countries/Fijuij.txt"
NOB = "countries/Nobatia.txt"
ZUW = "countries/Zwara.txt"
MSR = "countries/Misratania.txt"
JUF = "countries/Jufra.txt"
NEM = "countries/Nemenchia.txt"
OUA = "countries/Ouargla.txt"
#Baltic Region
SKL = "countries/Skalovovia.txt"
YOT = "countries/Yotvingia.txt"
GLA = "countries/Galindia.txt"
SEM = "countries/Semigalia.txt"
ZEL = "countries/Selonia.txt"
LAT = "countries/Latgalia.txt"
ZHM = "countries/Samogatia.txt"
#Rus'
PRJ = "countries/Pereyaslav.txt"
PIN = "countries/PinskTurov.txt"
BLZ = "countries/Belz.txt"
PRZ = "countries/Przemysl.txt"
KRS = "countries/Kursk.txt"
MSK = "countries/Minsk.txt"
MST = "countries/Mstislav.txt"
VTB = "countries/Vitebsk.txt"
RYL = "countries/Rylsk.txt"
PTV = "countries/Poltava.txt"
VYM = "countries/Vym.txt"
GCH = "countries/Galich.txt"
#Persia & Middle East
KTE = "countries/Ctesiphon.txt"
EDE = "countries/Edessa.txt"
SRA = "countries/Soran.txt"
KKT = "countries/Kakheti.txt"
KTL = "countries/Kartli.txt"
MGL = "countries/Mingrelia.txt"
ABK = "countries/Abkhazia.txt"
THA = "countries/Thaqif.txt"
KIN = "countries/Kinana.txt"
UDH = "countries/Udhrah.txt"
HUM = "countries/Hum.txt"
LGC = "countries/Lignica.txt"
SWD = "countries/Swidnica.txt"
KUY = "countries/Kuyavia.txt"
RAT = "countries/Ratibor-Opava.txt"
RHI = "countries/RhineLeague.txt"
LEO = "countries/BroLeon.txt"
WUJ = "countries/Wujda.txt"
IDU = "countries/Idukal.txt"
AMZ = "countries/Amzur.txt"
ASF = "countries/Asfi.txt"
OUS = "countries/Ouarsenis.txt"
TUT = "countries/Tuat.txt"
ORY = "countries/Oryol.txt"
TTU = "countries/Tartu.txt"
SRC = "countries/Soroca.txt"
ABZ = "countries/Abaza.txt"
KRB = "countries/Karabadia.txt"
NKH = "countries/Nakh.txt"
ALN = "countries/Alania.txt"
BGY = "countries/Bolgary.txt"
MOG = "countries/Mogostan.txt"
BMM = "countries/Bam.txt"
PLS = "countries/Palestine.txt"
MTY = "countries/Mutayr.txt"
HRB = "countries/Harb.txt"
HWZ = "countries/Hawazin.txt"
COA = "countries/Chola.txt"
SAA = "countries/Sena.txt"
QAT = "countries/Qatar.txt"
ZAB = "countries/Zabulistan.txt"


#meme
BKU = "countries/BloodCult.txt"